####################################
#                                 T#
# ####################### ######## #
# ##   #   #      #######   ##     #
# ## # # # # #### ######### ## #####
# ## # # # #             ## ##     #
# ## # # # # # ####  ###    ###### #
# #  # # #   #    ## ########      # 
# ## # # ######## ##        ## #####
# ## #   ##       ######### ##     #
#    ###### #######      ## ###### #
######      #       #### ## #      #
#      ###### ##### #    ## ## #####
# ######      #       ##### ##     #
#        ###### ########### ##  ## #
##########                  ###### #
#.         ################        #
####################################